@###....##
.#.##.#..
...#####.#
#....###.#
####.#...#
#.##.##..#
#.##.##.##
#....##.#
###.##..##
.##....###