
.#########
.#.......#
.#.#####.#
.#.#@..#.#
.#.###.#.#
.#.....#.#
.#######.#
.........#
##########