...###.....
..##.#.####
.##..###..#
##........#
#..#@#.#..#
########..#
..#..#....#
.##.##.#.##
.#......##
.#.....##
.#######