###...###.
#####.....
@##
.....#.#..
##......##

##..##..##
#....
#######
##
.......##