.###.....#
.#....##.#
......#..#
...###....
..##...#..
....#.....
.##....###
...##.....
###.....@.
..##..#.#.